TRENNBARES VERB
=====================
1. abgeben - submit
2. abnehmen - lose weight
3. abschließen - complete, finish ( project, study, degree)
4. angeben - to show off ( i have a BMW Car :P )
5. anschauen - watch
6. anrufen - call
7. aufnehmen - record video or take a picture
8. aufräumen - tidy up/ clean up ( example room)
9. aufwachsen - grow up.. (ich bin in karkala aufgewachsen)
10. ausdrucken - print ( picture or paper)
11. ausdrücken - express opinion, feelings (vyaktapadisu)
12. ausgehen - go out... ich möchte mit meinen Freunden ausgehen

13. losfahren - leave, get going ( wir fahren jetzt nach Bangalore los)

14. mitbekommen - realize, ich habe mitbekommen, dass Suresh in Unterricht nicht gekommen ist.
15. mitfahren - drive together, Meine Frau und ich fahren nach Mumbai jedes Jahr mit
16. mitmachen - participate, join - Wir wollen cricket spielen. Willst du mitmachen ?
17. mitteilen - inform - Er hat mitgeteilt, dass er nach Indien am Samstag fliegt.
18. mitnehmen - take along,  ich nehme Foto von meinem Papa immer mit.

19. nachdenken - think about, ich möchte darüber nachdenken ( i want to think about that)
20. nachprüfen - double check (essay, documents) , ich muss immer meine Antworten nachprüfen.

21. stattfinden - an event taking place... Die Party findet am Samstag um 16 Uhr statt.
				       Die Party hat am Samstag in letztem Jahr stattgefunden.

22. vorbereiten - prepare
23. vorhaben - plan, have something in mind.. ich habe eine Idee vor
24. vorkommen - happen, Heute sit ein Problem vorgekommen !
25. vorstellen - this has 2 meanings, introduce and imagine
	kannst du dich vorstellen ? can you introduce ?
	kannst du dich in Indien jetzt vorstellen ? can you imagine yourself in India now ?

REFLEXIVES VERB
=================
	ich	  mich	
	du	  dich	
	er/sie/es  sich	
	wir	uns	
	ihr	euch	
	sie/Sie	sich	
1. sich ärgern - to get angry, (Manuel und Paula ärgern sich über das Wetter)
2. sich bewegen - to move, ( Am Wochenende möchten wir uns  ein bisschen im Garten bewegen)
3. sich freuen  - to be happy ( ich freue mich auf Geburstagfeier am Samstag ! )
4. sich setzen   - to sit down ( ich bin müde, weil ich Fitness Studio besucht habe. Ich möchte mich jetzt setzen)
5. sich treffen  - to meet, ( könntest du bitte Bescheid geben, ob wir uns am Sonntag treffen können ?)
6. sich verabschieden - to say goodbye ( Nach der Party können wir uns verabschieden)
7. sich baden - to take a bath	Ich bade mich gern jeden Sonntag.
8. sich duschen- to shower	Es ist gesund, sich manchmal kalt zu duschen.
9. sich rasieren	- to shave ich muss mich diese Woche für das Interview rasieren ( i must shave this week for the interview)
10. sich  beeilen  (pronunciation BE-AyLEN )- to hurry - Wir müssen uns für den Sitzplatz im Bus beeilen  ( we must hurry to get bus seat)
11. sich  verspäten- to be late - Es gab Unfall. Deshalb haben wir uns verspätet. (Unfall - accident, partizip 2 verspätet)
12. sich  benehmen, - to behave - Ich muss mich in der Schule gut benehmen.
13. sich  entschuldigen - to apologize ich muss mich für die Verspätung entschuldigen ( i must apologize for the delay)
14. sich vorstellen - to introduce oneself - Können Sie sich bitte vorstellen ? ( can you introduce yourself ?)
15. sich  erinnern an - to remember	- ich errrinere mich an meine Kindheit ( i remember about my childhood)
16. sich  erinnern an - to remind ( another meaning) - ich errinere mich meinen Bruder an seine Prüfung am Samstag ( i reminded my brother about his exam on saturday)
17. sich freuen auf - to look forward to - ich freue mich auf deinen Besuch ( looking forward for your visit)
18. sich freuen über - to be happy about - Ich freue mich über deine Hochzeit ( i am happy about your wedding)
19. sich  interessieren für	- to be interested in - Er interessiert sich für Cricket Spiel am Samstag
20. sich  kümmern um - to look after, to take care of - Mein Brüder kümmert sich um alte Eltern ( my brother takes care of old parents)

EXPRESSING OPINIONS
======================
1. Ich glaube, dass Cricket ein gutes Spiel ist.           => i believe, that cricket is good game
2. Ich bin der Meinung, dass Cricket ein gutes Spiel ist.  => i am of the opinion, that cricket is good game
3. Meines Erachtens ist Cricket ein gutes Spiel.           => As per my observation/understanding, Cricket is good game
4. Meiner Meinung nach ist Cricket ein gutes Spiel.        => As per my opinion, Cricket is good game
5. Ich denke, dass Cricket ein gutes Spiel ist             => I think that cricket is good game.

Some Link : https://deutsch.lingolia.com/de/wortschatz/zahlen-datum-uhrzeit/kardinalzahlen
































