abgesehen davon - other than fact
abschliessen - to complete
ahnen - assume
angeben - to give details (Angabe - Details)
anhalten -to stop , kannada: tade hidi
anstellen - to employ, engage
aufgeben - to give up ( not Aufgabe -Task)
ausbauen - to expand
ausgeben - to spend, also result ( Ausgabe)
ausreichen -  to be sufficient
auszeichnen - to reward
bedienen - to operate
befinden -  to be located, to be situated
behalten - to keep, kannada: ittu KoLLu
besitzen -to own
beten  - to pray (partizip 2: gebetet)
beweisen - to prove
bewerten - evaluate (Bewertung rating)
bieten - to provide  (partizip 2 : geboten )
bitten - to request  (partizip 2 : gebeten )
dienen - to serve
einbauen - to mount
eingeben - to give input (Eingabe Input)
eintragen - entry in (in a form for example)
empfangen - to receive
entdecken - to discover
entlassen - to dismiss
entschliessen - to determine
erfinden - to invent
ergänzen - to fill in (the blanks)
erhalten - to receive ( bekommen)
erwerben - to acquire
fangen - to catch
fehlen - to lack
halten - to hold
nachdenken -  to rethink kannada: aalochisu
nachweisen - to verify
reichen - to be enough
sperren - to block, suspend
stecken - to stick
stellen - to put, to place
stimmen - to attune, kannada : dwanigoodu
tragen - to carry
träumen - to dream
überweisen - to transfer (money, power)
urteilen - to judge
verbereiten - to spread
verbergen - to cover, to hide kannada: Maremaachu 
verbleiben - to remain
versetzen - to relocate
versprechen - to promise
verstecken - to hide
zeichnen - to draw ( partizip 2: gezeichnet)
zeichnen - to draw, 
zeigen - to show ( partizip 2: gezeigt)
zitieren - to quote 
zuordnen - to match kannada: hondisu
zustimmen - to agree
zuweisen - to assign