Abständen - intervals, Gaps
angeblich - supposedly
angeblichen - alleged, ಹೇಳಲಾಗಿರುವ, 
Aufpreis - Additional cost
außer - except,beside
beliebegen - any, yavudadaru
bereits - already
Bewerber - applicant 
Börsekrachlöste - stock market crashes
couch - sofa
Daher - hence
ebenfalls - also, likewise
eher -rather
enorme_summe - massive sums
Fachterminus - Technical term, ತಾಂತ್ರಿಕ ಪದ
gefürchtet - feared
gegenüber - towards, opposite
gemütlich - comfortable
Genres - types
Geshäftreisen -  Bussiness tour
günstigen - cheapest
heim - home
herkömlichen - usual, conventionally, SAAMANYAVAGI
hingeben - whereas, however
jedoch - however
keinesfalls - by no mean
konkurrenz -  competition
konventionelle - conventional
kostprobe - sample
Krankmeldungen - Sick Notifications
Langstreck - long distance
Lastwagen - lorry, track
Lücken - gaps
luxuriös - luxurious
mehrmals - repeatedly, manytimes
Merkwürdiger - Stranger, ODD, ವಿಚಿತ್ರ
Monatdurchschnitt - Monthly average
niedrigen - lower
Pärchen - couple, pairs
pauschalreisen - package tour
Reiseveranstalter - travel bussiness
schlichte - simple, plane, ಸರಳ
schnäppchen - bargain
Sessel - arm chair
sitzgelegenheit - seating accommondation
sitzreihe - seat row
Stellen - places
Storm - Electricity
tatsächlich - actually
überwiegend - mainly, predominatly
umsonst - costless, free
Unglucksfälle - crash accident
unterwegs - under the waz, in transit
verfügung - disposition, ಇತ್ಯರ್ಥ
vergeblich - useless, vain, ವ್ಯರ್ಥ
verlockenden - tempting, ಪ್ರಲೋಭನಗೊಳಿಸುವ
Verspätungen - delays
verstärke - strengthen
Vertreibung - explusion, uchhatane
vorab - beforehand
voraussetzung - prerequisites
vorsichtig - careful
vorurteile - biased, ಪೂರ್ವಾಗ್ರಹಗಳು
wiederrum  - again
Zeitverschiebung - time lag, ಸಮಯ ಬದಲಾವಣೆ
zusätzlich - additional
zuvor - previously
zwangläufig - compulsarly
Zwangslaufig - unavoidable, ಅನಿವಾರ್ಯ
