aberglauben - superstitious, andhavishwasa
abläufen - to expire
abpacken - to pack something
anbieten - to offer
angucken - to look at
anziehen - to change dress
auffallen - attract attention, to stand out
auffüllen -to fill in
auftreten - to occur, ಕಾಣಿಸಿಕೊLLu
ausbilden - to train
ausbreiten - to spread, ಹರಡu
aushalten - to bear, to abide
ausstellen - to exhibit, to show
beantragen - to reqest, to apply for
befinden - to decide
beschränken_sich - to restrict
bestätigen - to confirm, to approve
betreffen - to affect, ಪರಿಣಾಮವಾಗು
bevorzugen - to prefer
beweisen - to prove
bewerben_sich - to applz for job
drankommen - to have ones turn
drauflegen - to put on it
durchgehen - to pass, to go through
eignen_sich -to suit
einbauen - to install
eingehen - to enter
einschalten - to activate
einwerfen - to insert
empfangen - to receive 
empfehlen - to recommond
entmutigen - discourage, ನಿರುತ್ಸಾಹಗೊಳಿsu
entsprechen - to correspond
entstehen - to arise, to emerge, ಹೊರಹೊಮ್ಮು, ಉದ್ಭವಿಸu
erfinden - to invent
ergänzen - to fill up (bitta sthala tumbi)
erhalten - to receive
erholen - to relax
erklingen - to sound
erkunden - to explore
erledigen - to settle
ermöglichen - to enable, ಸಕ್ರಿಯಗೊಳಿಸu, ಅಧಿಕಾರ ಕೊಡು
ermütigen - encourage, ಪ್ರೋತ್ಸಾಹಿಸ
ernähren - to feed
ertragen -to suffer, to endure
erwähnen - to mention
erweitern - to extend
existeren -to exist
feststehen -to be fixe
freuen_sich - to be glad
gelten - to take effect, ಜಾರಿಯಲ್ಲಿರಿvudu (rule, law)
geschloßen - to close, to shut
gewehren_sich - to defend
halten - to keep, to hold
kontakte_knüpfen - to make contact
kritisieren - to critisize
leiden - to suffer
liegen - to be located
markieren - to mark
messen - to measure
mithalten - to keep up, to match up
mitverfolgen - to follow
nerven - to get nervous
reinschauen - to drop in 
schädigen - to harm, to injure
sich_verhalten - to behave
sichern - to ensure
speichern - to save data
sprengen - to burst, to blast
statten - to permitted, to allower
stecken - to stick
stimmen - to voice, ಧ್ವನಿ ಎತ್ತು
Strecken - to stretch, to spread out
tauschen - to swap
überlegen - to consider
überzeugen - to convience, ಮನವೊಲಿಸu, ಮನಗಾಣಿಸು
umgeben - to surround
umgehen - to byepass
umstellen - to shift
veranstallen - to host, to arrange, event ಆಯೋಜಿಸu 
verbringen - to spend time
verbunden - to connect
verkaufen - to sell
verlassen - to leave
verlinken - to link
verloren - to lose
verpassen - to miss something ತಪ್ಪುವಿಕೆ
verraten - to betray
verreisen - to make trip
verzichten - to quit
vorbereiten_auf - to prepare
vorfinden - to find, discover
vorspielen - to audition
wachen - to watch
wachsen - to grow
werfen - to through
wohlbefinden - well being
zogen - to pull
zurückhalten - to restrain, ನಿಯಂತ್ರಣ maadikoLLu
