ableiten - deflect, haLLa hidi
Abnutzen - abuse, DurbaLake madu
agieren - to act, vartisu 
aktualisieren  - to update,
akzeptieren - to accept
angreifen  - attack, daaLi madu
anklagen -  to accuse, aaropa maadu, aapadisu
annehmen - to accept
anpassen - to adjust
anschauen - to view, nodu 
ansehen -  to view, nodu
Anwenden - to apply  Anwayisu, Apply, to use
argumentieren - to argue
auferlegen   - impose, hEru
﻿beachten  - gamanisu , to note, to observe
bearbeiten  - to edit, to process usually textual content
bedeuten  - arthaisu, to mean
bedrohen  - threaten, bedarisu, hedarisu
beeilen  - hurry up
beeinflussen  - influence
beglaubigen - pramaanikarisu, dhrudikarisu
beheben -  to rectify, saripadisu
bekommen - to receive
bemessen - to measure, aLeyu
benötigen - to require
benutzen - use, baLasu
berichten  - to report, varadi madu
berücksichtigen  - consider
beschädigen - to damage, haani madu
beschäftigen - to employ, to engage
beschreiben - to describe
besichtigen - to view, nodu mattu pareekshisu
beteiligen - to involve, to take part, 
betonen  - ottu kodu, emphasize
betrachten - to consider, to look into
betrügen  - to cheat, mosa madu, vanchisu
beweisen - to prove
bewerben  - job apply
bezeugen - witness, saakshiyagu
bitten  - to request appeal, manavi madu
brauchen - to require
darstellen  - illustrate, pose, vivarisu
darstellen  - to pose, 
dauern  - to last
demonstrieren  - demonstrate, pradarshisu
empfägen - to receive
empfinden - to feel
enthalten - to contain, to comprise, kannada : OLagollu
entsprechen - to correspond, 
erfordern - to require
ergreifen  -  to take measure, kaigoLLu
ergreifen  - maßnahmen ergreifen  - to take action
erklaeren - to explain
erläutern - to explain
erneuen  - to renew, naveekarisu
Ernst nehmen - take serious, Gambhiravagi parigaNisu
erscheinen  - appear
ersetzen  - replace
erzaehlen - to describe
erzeugen  - create
Fortschreiten - to progress
fuehlen sich - to feel
genehmigen - to approve, to permit
greifen - grab, grasp, hididuko
hassen  - to hate, Dweshisu
herstellen  - manufacture, tayarisu
interpretieren - to interpret, arthaisikollu
jdn_trösten - to console, samadhanapadisu
jdn_überzeugen - to convince
Kombinieren - combine, join
Konvertieren - to convert, religion, Konvertierung  - Noun
korrigieren - to rectify, saripadisu
leiden  - to suffer, baLalu
leiten  - to lead, netrutva vahisu
meinen  - to mean, 
messen - to measure, aLeyu
mitteilen - to inform, maahiti kodu
niederschlagen  - to defeat, solu vante maadu
nutzen - use, baLasu
protestieren  - protest, pratibhatisu
quälen  - to torture, chitrahimse kodu
randalieren  - to riot, galabhe madu 
rauben  - to loot, looti hode
reagieren - to react, pratikrayisu
rechnen  - lekka haaku, to count, calculate
schädigen - to damage, haani madu
schildern - to describe
segnen  - to bless, aashirvadisu
specifizieren - specify, nirdistapadisu
streiten  - to fight
übersehen - overlook, kadegaNisu
übersetzen - translate
umrechnen - also to convert but with maths, dollar to euro, miles to Kilometer etc.
verbessern - to improve
verboten - to prohibit
verbrauchen - consume, Kannada: Sevisu
Verhindern - to prevent
verlassen  - leave, bittu bidu
verletzen  - injure, novuntu madu, gaya madu
verletzen - to hurt, noyisu
verschwenden -  to waste, vyartha madu
verschwunden -  disappear, missing,  kanmareyaagu
verwenden - BaLasu, upayogisu
Verwenden- use, kannada: BaLasu
verwunden - to get wound, gaayagonda
verzichten  - to quit, tyajisu
widerlegen - refuse, tiraskarisu, niraakarisu
widerreden - to contradict, virodhabhasavgi helu
widerrufen - revoke, vapasur kare, raddumadu
widersprechen  - to object, prashnisu, 
wiederherstellen   - restore, marunirmaana madu
wiederspiegeln - to reflect
zuordnen - to match, hondisu
zurückhalten - refrain, kannada: dooraviru