Abreise - Departure
Abschlussprüfung - final exam
Aktuell - Current
anstrenged - tiring,exhausting
ausgiebig - extensive,substantial, ಗಣನೀಯ, ವ್ಯಾಪಕವಾಗಿ
ausnahmeweise - exceptionally
Äußerungen - expression
Bahnfahten - train rides
begriff - term
Belastend - stressful
Belibtheit - popularity
Berghof - ward
berufstätig - professional, working
Berufswahl - carrier choice
Beschwerden - complaints
Betreff - Subject, ವಿಷಯ
Betrieb - plant, enterprize
Bewertungen - Valuation
Bürger - Civic, Citizen
damals - back then
dauerhaft - durable, permanent 
dennoch - yet,still
donnert - thunder
Dreieck - triangle
eben - even
eillig - hurry, urgent
eingebußt - suffered
Einnahmen - receipt, revenue
empfindlichen - sensitive
ersetzer - replacer
exotisch - exotic
externen - external
festen - strong hold
feststehen - to be fixed
Firmeninhaber - company owner
frühstückstich - Breakfast Table
Gang - Passage, ಮಾರ್ಗ
Gefahr - hazard
Geländer - railing
genauso - just like that
geräusche - Noise
geregelten - governed
gering - slight, minor
gesamten - overall
Gewerbschein - trade certificate
gewinnbringende - Profittable
Glückzahlen - lucky number
grundsätzlich - basically
hauptsächlich - mainly
Hauptverkehrstraße - main road
Hausordnung - house rules
Haustür - front door
herum - almost
Herzinfarkt - Heart attack
Hörnerven - hearing nerve
Hörstörungen - heart disorder
Inhaltverzeichnis - Contents
irgendwann - somewhere
kopfhörer - headphone
Lärm - Noise
Lärmbelastigung - noise pollution
Lärmveraursacher - noise pollution
Lauffeuer - wild fire
Lautstärke - volume, loudness
Leistungen - achievements
los - fate,destiny
Medientag - Media Day
misserfolg - failure
Mitglieder - members
möglicherweise - possibly
Nachrichtsportale - News portals
Nachtruhe - Night peace
Niveau - level
oberflächlich - superficial, ಬಾಹ್ಯ, ಹುರುಳಿಲ್ಲದ
Rasen - Races,ಜನಾ೦ಗ (not fast speed race)
Rassen - Race, speed race
Rauscht - whisper, pisumatu
Reichwerte - Rich values
Rutsche - slide
schallschutzfenster - sound proof windows
schausteller - showman
Schon_lange - long time
schweringen - more difficulty
seelisches - Spiritual, ಆಧ್ಯಾತ್ಮಿಕ
Selbverständlich - self evident
selten - rare
sensibler - more sensitive
so_gut_wie_gar - almost not at all 
sogar - even, yet
spannende - thrilling
staatkassen - city treasuries
stammschule - coming school
ständig - constantly, always
Startseite - Home page
störend - disturbing
Stressauslösen - stress triggers
stundenlang- hours long
Tagesablauf - daily routine
Teppiche - carpets, rugs
Tiefe - deep
Tippschein - lottery ticket
Überall - everywhere
Überschrift - heading
übertragungen - transmissions
übrig -  remaning, ಉಳಿದ
übringen - all the rest
Umständlich - laborious, ಪ್ರಯಾಸಕರ
unerheblich - irrelevant ಅಪ್ರಸ್ತುತ
ursprünglich - original
Veränderungen - diversification
verantwortung - Resposibility
Verkehrslärm - traffic noise
vertraünwürdig - trustworthy
Verwendet - uses
Volkfest - Public festival
Volkfestplatz - fairplace
Volksport - national sport
waisenkind - Orphan
wanderleben - Unsettled life
weckerlingeln - alaram clock ring
wertsachen - Valueables
wohl - well
Wohlbefinden - well being
wohnsitz - residence
wohnwagen - van, Caravan
zeiten - time
zeitfresser - time eater 
Zeitgeschehen - current affairs, ಪ್ರಚಲಿತ ವಿದ್ಯಮಾನ
zettel - slip, note, bill, ಚೀಟಿ
zeugnis - certificate,report
zogen -pullen
zugang - Access
Zusammengetragen - Carried together
Zuschauer - spectator
