Abdruck  - imprint, kaalachchu, Mudre
Abfall  - waste, garbage
Ablauf  - Procedure
Abnutzung  - abuse, DurbaLake
Absicht  - puprose, uddeesha
absichtlich  - purposefully, uddeshapporvakavagi
Abteilung  - department, ilaakhe
ähnlich  - similar, holuva, samavada
aktiv  - active, sakriya, chatuvatikeyindiru
Ansicht  - opinion, view, abhipraya, nota
Ansprechpartner  - contact person, samparka vyakti
Anwendung  - usage  Kannada: BaLake,
Aufmerksam - attentive
Aufmerksamkeit  - attention, Gamana
Bedürfnis  - need, Avashyakate
befristet - temporary, taatkalika
Beglaubigte  - pramaanikarisida, dhrudikarisida
Behindert  - impaired, disabled
benötigt  - necessary, required
Bereich  - area, Kshetra
Beschäftigung - Occupation
besondere  - special, visheshavada
bestimmt  - particular, nirdishtavada
Beteiligung  - involvement
Betrieb  -  operations, business, firm
betroffene  - affected, concerned, baadhitha
Betrug  -  Cheat, Vanchane, Mosa
brutal  -  violent, himsatmaka
Chaos  - Kaavos, Kannda: Gondala
dauerhaft  - permanent, shashwata
der Hass  - Hate, Dwesha
Digitalizierung - Digitalization
Druck  - Pressure
durchschnitt  - sarasari
durchsichtig  - transparent, paradarhska
ehemalig  - Former, maaji
Einsam  - lonely
Einsamkeit  - loneliness
einwandfrei  - adjective, Perfect, paripoorna
elementar  - basic, fundamental
entsprechende  - corresponding, anuroopavada
Erfolg  -  Victory, Jaya
erforderlich  - necessary, required
Ernst  -  serious, Gambhira
ewig - forever, shashwata
Fachbereich  - department, vibhaga
Fahrzeug  - vehicle, vaahana
Fehlerlos  -  without problems
Feindschaft  -  enmity, Vairatva
Fläche  - area, Bhoopradesha
Fortschritt  -  abhivraddhi, progress
Freude  - joy, santosha
Freudig  - joyful, santoshadayaka
Freundschaft  -  friendship
Friede  - peace, shaanti
Friedlich  - peaceful, shaantiyuta
Froh  - joyful, santoshita
Fröhlich  - joyful, nagumogada
Gebiet  - area, Kshetra
Gegengrund  - Counter argument
Gelegenheit - Opportunity
gemäß+dativ  - according to..
Genehmigung  - approval
Gewalt - violence, Himse, dourjanya
Gewaltlosigkeit  - non violence, ahimse
gewaltsam  -  violent, himsatmaka
﻿Globalizierung - Globalization
grundlegend  -  fundamentally, kannada: Moolabhootavagi
Grundsatz  - Policy
grundsätzlich  -  fundamentally, kannada: Moolabhootavagi
Hectisch  -  Hectic
Herausforderung - Challenge
Hindernis  - obstacle, ade-tade
illegal - illegal, kanoonu bahira
Infrastruktur - Infrastructure
inzwischen  - meanwhile, ee naduve, ashtralli
Klima - Nature
Kohlenstoff  - Carbon
Kohlenstoffdioxid  - carbon dioxide
Kohlenstoffmonoxid  - Carbon monooxide
Kombination  - combination
Kommunal  - communal, komu
Kommunikation - communication
Konvertierung  - Covert (Religion)
laut + dativ, laut + gen  - according to..
Lebenswürdigkeit  - KaruNe, Daye
logik  - logic, tarka
Maßnahme  - Krama, Measure
Meinung  - opinion, abhipraya
Menschheit  - humanity
Modernizierung - Modernization
Müll  - garbage
Natur - Nature
Niederlage  -  defeat, solu
nötig  - necessary, required
notwending  - necessary, required
Nutzung  -  Kannda: BaLake
obligatorisch  - compulsory
Perspektiv -  prespective, Viewpoint, Drustikona
Pflicht  - compulsory
plötzlich  - suddenly, idakiddante, akaasmat
politisch  - political, raajakiya
prinzipiell  -  fundamentally, kannada: Moolabhootavagi
Prozess  - process, kannada: prakriye
Qual  -  torture, chitrahimse
Randale  - Riot, galabhe
Ressource  - resource, sampanmoola
Richtlinie  - Guideline, Kannada: Maargasoochi
Sauerstoff  - Oxygen
Schild, Schilder - sign
Segen  - Blessings, verb is SegNen
sicht  - sight, drushti
Sieg  -  Victory, Jaya
sofort  - imemdiately, tatkshana
Sprecher/in  - spokesperson, vaktaar
ständig  - constantly, nirantaravagi
Stoff  - Fuel, Indhana
Strategie  - strategy
tödlich  - deadly
Treibhauseffekt  - Greenhouse effekt
übersicht  - overview, pakshinota, avalokana
Umweltfreundlich - Enviornment friendly
unmittelbar  - immediate, takshanavagi
Verbesserung  - improvment
verbrauch  -  kannada: Sevane, consumption
Verfahren  - Procedure
Verfügbar  - available, kannada : Labhyavide, Doraku
Verlauf  - process, kannada: prakriye
Vertrieb  - marketing
Verwendung  - usage  Kannada: BaLake, 
Voraussetzung  - prerequisites, ಪೂರ್ವಾಪೇಕ್ಷಿತಗಳು
Vorgang  - process, kannada: prakriye
Vorgehensweise  - approach, strategy
vorsicht  - caution, precaution, ecchara, jagarookate
wesentlich  -  fundamentally, kannada: Moolabhootavagi
widerlich  - ashyakara, disgusting
widernatürlich  - against nature, aswabhavika
widerrechtlich - illegal, kanoonu bahira
widerspruch  - opposition, 
widerstand - resist, virdoshisu, tadedu nillisu 
widerwillig  - reluctant, manasillada 
Würde  - dignity, Ghanathe
würdig  - dignified
Zustand state, condition, sthithi
